
C  135, 206, 235

SO ./textures/wall2.xpm

WE ./textures/wall4.xpm
NO    ./textures/wall1.xpm



EA ./textures/wall3.xpm



F   128,128,128



      1111111111111111111111111111111
      1100000000000000000000000000001
      100000000000000000000000000001
      1011111100000000000000000000001
      100000000000000000000000011111
1111110000000000000111111111101
1100000000000000000000000000001
1100000000000000000000000000001
1100000E00000000000000000000001
1100000000000111111111111111111
1111111111111111111111111111111

